0 0 0 0 0 0 0 0 0 0 0 0 0 0 0 0 0 0 0 0 0 0 0 0 0 0
0 0 0 0 0 0 0 0 0 0 0 0 0 0 0 0 0 0 0 0 0 0 0 0 0 0
0 0 0 0 0 0 0 0 0 0 0 0 0 0 0 0 0 0 0 0 0 0 0 0 0 0
0 0 0 0 0 0 0 0 0 0 0 0 0 0 0 0 0 0 0 0 0 0 0 0 0 0
0 0 0 0 0 0 0 0 0 0 0 0 0 0 0 0 0 0 10 0 0 0 0 0 0 0
0 0 0 0 0 0 0 0 0 0 0 0 0 0 0 0 10 0 0 0 0 0 0 0 0 0
0 0 0 0 0 0 0 0 0 0 0 0 0 0 9 0 0 0 0 0 0 0 0 0 0 0
0 0 0 0 0 0 0 0 0 0 0 0 0 0 0 0 0 0 0 0 0 0 0 0 0 0
14 14 14 14 14 14 14 14 14 0 0 46 14 14 42 43 46 14 14 14 14 14 14 14 14 14
28 20 20 20 20 20 20 20 20 0 0 0 20 20 0 0 0 20 28 20 20 20 20 20 20 20
20 20 20 20 20 28 20 28 20 0 0 0 20 20 0 0 0 20 20 20 20 20 20 20 20 20
20 20 20 28 20 20 20 20 20 0 0 0 20 20 0 0 0 28 20 20 20 20 20 20 20 20
20 20 20 20 20 20 20 20 20 56 57 58 20 20 56 57 58 20 20 20 20 20 20 20 20 20
20 20 20 20 20 20 20 20 20 70 71 72 20 20 70 71 72 20 20 20 20 20 20 20 20 20
